XXXXXXXXXXXXXXXXXXXXXXXXXXXXXXXXXXXXXXXXXXXXXXXXXXXXXXXXXXXXXXXXXXXXXXXXXXXXXXXXXXXXXXXXXXXXXXXXXXXXXXXXXXXXXXXXXXXXXXXXXXXXXXXXXXXXXXXXXXXXXXXXXXXXXXXXXXXXXXXXXXXXXXXXXXXXXXXXXXXXXXXXXXXXXXXXXXXXXXXXX
P       X       X X       X     X                   X   X       X                   X           X X           X   X     X                     X           X               X     X         X     X       X
XXX XXXXX XXX X X X XXXXX X X XXX XXX XXXXXXXXXXXXX X XXX XXX X X XXXXXXX X XXX XXXXX XXX XXXXX X X XXX XXXXXXX X X XXX X XXXXXXXXXXXXXXXXX X X XXXXXXXXX X XXXXXXX XXXXX X X XXX X XXXXX X XXXXX X XXX X
X   X       X X X       X   X     X   X     X   X     X   X   X X X     X X X X X       X     X   X   X         X X X X X   X X             X X X       X   X   X   X       X X   X X   X X X     X X X X
X XXX XXXXXXX X X XXXXXXXXXXX XXXXX XXX XXX X X XXXXXXX XXX XXX XXX XXX X X X X X XXXXXXXXXXX XXX XXX XXXXXXXXXXX X X X XXX X X XXXXXXXXXXXXXXX X XXXXX XXX X XXX XXXXXXXXXXXXX XXX XXX X X X XXXXX X X X
X X   X   X   X X   X       X     X       X   X           X X   X   X X X X X   X X           X   X   X       X   X X X       X   X         X   X     X   X   X   X           X   X   X     X   X   X X X
X X XXXXX X XXX XXXXX XXXXX XXXXX XXXXXXXXXXX XXXXXXXXXXXXX XXX X XXX X X X XXXXX X XXX XXXXX XXXXX XXX XXXXXXX X X X XXXXXXXXXXX X XXXXXXX X XXXXXXX XXX XXX X X X XXXXXXXXX XXX XXX XXXXXXX XXX XXX X X
X X     X X X X     X X   X     X   X   X   X   X     X   X   X X X   X X X       X X   X   X X     X   X     X X X X     X     X X X     X     X   X   X X   X X X X       X   X   X   X     X   X     X
X XXXXX X X X XXXXX X XXX XXXXX XXX X X X X XXXXX XXX X X XXX X X X XXX XXXXX XXXXX X XXX X XXX XXXXX XXX XXX X X X XXX XXX XXX X X X X XXXXXXXXX X XXX X XXX X XXX X XXXXX X XXXXX XXX X XXXXX XXXXX XXX
X         X X       X X       X X X X X   X     X X   X X     X   X   X     X X   X X X   X   X X   X       X X X X   X   X   X   X X X X       X X X   X   X X   X   X   X X     X   X     X   X   X   X
X XXXXXXXXX X XXXXXXX X XXXXX X X X X XXXXXXXXX X X XXX X XXXXXXXXXXX XXXXX X X X X XXX XXXXX X X XXX XXXXXXX X XXXXX XXX XXX XXXXX XXX X XXXXX X X X XXXXX X XXX XXXXXXX X XXX XXXXX XXXXXXX X X X XXXXX
X   X   X   X         X X     X X   X X       X   X X   X X         X X     X X X X X   X   X   X         X   X     X X   X X     X     X   X   X X   X   X X   X   X     X   X X   X     X   X X X X   X
XXX X XXX XXXXXXXXXXXXX X XXXXX XXXXX XXX XXXXXXXXX XXX XXX XXXXXXX X X XXXXX X X X X XXXXX XXXXXXXXXXXXX X XXXXXXX X X X X XXXXX XXXXX XXX X XXX XXXXX X X XXXXX XXX X XXXXX X X X XXXXX X X XXX X X X X
X X   X   X       X     X     X     X   X   X     X   X     X   X   X   X   X   X X X         X         X X       X X X X       X     X X   X     X     X X     X     X     X X X X       X X X   X   X X
X XXX X X X XXXXX X X XXXXXXXXXXXXX XXX XXX X X XXXXX XXXXX X X X XXX XXXXX X XXXXX XXXXXXXXX XXX XXXXX X XXXXX X X X X XXXXXXX XXX XXX X XXXXXXXXXXXXXXX XXXXX X XXXXX XXX X X X XXXXXXXXX X X XXXXXXX X
X   X X X X   X   X X   X         X X   X   X X     X     X X X   X X     X   X   X   X     X     X   X X X     X X   X X     X X   X   X   X             X     X X   X X   X X X X       X X X     X X X
X X X X X XXX X XXXXXXX X XXXXX XXX X XXX XXX XXX XXXXXXX XXX XXXXX XXXXX X XXX X XXX X XXX XXXXXXX XXX XXX X XXXXXXXXX X XXXXX X XXX XXXXX XXX X XXXXXXX X XXXXXXX X XXX X X X X X XXX XXX X XXXXX X X X
X X X X X   X X       X     X   X   X   X     X X       X   X X   X   X   X X   X     X X X         X   X   X X         X       X         X X   X X     X X   X     X X   X X X   X   X   X X   X     X X
XXX X X XXXXX XXXXXXX XXXXXXX XXX XXXXX X XXXXX XXXXXXX XXX X XXX X X X XXXXX XXXXXXXXX X XXX XXXXX X XXX X XXX X XXX XXXXXXXXXXX XXXXXXXXX X XXXXX XXX XXXXX X XXXXX X XXX X XXXXXXXXXXX X XXXXX XXXXX X
X   X X X     X   X X X     X   X X     X     X   X   X   X X X   X X   X   X         X X   X   X   X X   X X   X   X X         X X   X     X X     X X X   X   X       X X X X           X         X   X
X XXX X X XXXXX X X X X XXX X X X X XXXXXXXXX X X X X XXX X X X XXX XXXXX X XXX XXXXX X XXX XXX X XXX X X XXX XXXXX XXX XXXXXXX XXX X X XXXXX X XXXXX X X X X XXXXXXXXXXX X X XXXXX XXXXX XXXXXXXXXXX X X
X     X X X     X   X     X X X X   X X     X   X   X X   X   X   X X     X   X X   X       X   X X   X X X       X X   X   X   X   X   X     X X     X   X   X       X   X X   X   X   X   X   X     X X
XXXXXXX X XXX XXX XXXXXXXXX XXX XXXXX X XXX XXXXXXXXX X XXXXXXX X X X X XXXXX XXX X XXXXX XXX XXX X XXXXX X XXXXXXX X XXX X X XXX XXXXXXX X X X X XXX XXXXX XXX XXXXX X X X XXX X XXX X XXX X X X XXXXX X
X     X       X   X         X         X X X   X     X X       X X   X X   X X   X X     X X   X X X X   X   X   X   X   X X       X X     X X X   X   X   X   X X   X X X     X   X X X X   X X X     X X
X XXX XXXXX XXXXXXX XXXXXXXXX XXXXX XXX X XXX X X XXX XXXXX XXX XXXXXXXXX X XXX X XXXXX X X XXX X X X X XXX X X X XXXXX X XXXXXXXXX X XXXXX X XXXXX XXX X XXX X XXX X XXXXXXXXXXXXX X X X XXXXX XXXXX X X
X X X X   X X   X   X       X   X   X   X   X   X X   X   X             X X   X X X   X X X X   X X   X   X X X   X     X X       X     X   X   X   X X X X   X     X X     X       X X   X       X   X X
X X X X X X X X X XXX XXXXX XXX XXXXX XXXXX XXXXX X XXXXX XXXXXXXXXXXXX X X XXX X X X X X X XXX X XXXXXXX X X XXXXX XXXXX X XXXXX XXXXX X XXXXXXX XXX X X XXXXXXXXX X X XXX X XXXXX X XXXXXXX XXX X XXX X
X X     X X X X   X   X   X   X X   X     X   X   X X   X   X   X       X X     X X X X X X   X X   X     X X     X   X X X     X     X X       X X   X X   X   X   X X   X X   X X   X     X X   X   X X
X XXXXXXX XXX XXXXX X X X XXX X X X XXXXX X XXX X X X X X XXX X XXXXX XXX XXX XXX X XXX XXXXX X XXX X XXXXXXXXXXX XXX X X XXX XXXXXXX XXXXXXXXX X X X X XXX X X X XXX XXX X XXX X XXXXX XXX X X XXXXX X X
X   X   X   X     X X   X   X   X X       X X   X X X X   X   X     X   X   X X   X   X X     X   X X       X   X X   X   X   X   X   X       X     X X   X   X   X     X X   X X       X     X X     X X
X X X XXXXX X XXX XXX XXXXX X XXX XXXXXXXXX X XXXXX X XXXXX XXXXXXX XXX XXX X X XXXXX X X XXXXX XXX XXXXXXX X X X X X XXXXX XXX X X XXX XXXXX XXXXX XXXXX XXXXXXXXX XXX X X XXX XXXXX XXXXXXXXX X XXXXX X
X X X     X X X X   X X X   X X   X         X X   X   X     X     X   X     X X X     X X X         X     X   X X X X X   X X   X   X   X   X     X X     X       X   X X X   X       X       X X X   X X
XXX XXX X X X X XXX X X X XXXXX XXXXXXXXX XXX X X XXX X XXXXX X XXXXX XXXXXXX X X X XXX X XXX XXXXXXX X XXXXXXX X X XXX X X X XXXXXXX XXX X XXXXX X X XXXXXXX XXXXXXX XXX XXX XXXXXXX X XXXXX XXX X X X X
X   X   X X X   X   X X X X   X X       X X   X X   X X X   X X     X       X   X X X   X   X     X X X       X X X     X X X     X   X   X   X   X X   X   X       X     X X     X   X     X     X X X X
X XXX XXXXX XXXXX XXX X X X X X X X XXX X X XXX X XXX X XXX X XXX X XXXXXXX XXXXX XXX XXX X XXXXX X X XXXXXXX X X XXXXXXX X XXXXX X XXXXXXXXX X XXXXXXX X X XXX XXX XXXXXXX XXXXX X XXXXXXX XXXXXXX XXX X
X X             X X     X   X X X X X   X X X   X   X X   X   X   X X       X   X     X   X   X X   X X     X   X       X X   X   X   X       X X     X X X   X X   X         X   X   X   X   X     X   X
X XXXXXXXXXXXXX X XXXXXXXXXXX X XXX X XXX X X XXXXX X XXX XXXXX XXX X XXXXXXX X X XXXXXXXXX X X XXX X XXXXX XXXXX XXX XXX XXX X X XXX X XXXXXXX X XXX X X XXX XXX XXX XXXXX X X X XXX X X XXX XXX XXX XXX
X X         X     X   X     X       X X   X   X X   X   X   X   X X X X     X X   X       X X X X   X     X         X   X   X X X X   X       X   X   X X   X X   X   X X   X X X   X   X X X   X   X   X
X X XXXXXXX XXXXXXX X X XXX XXXXXXXXX X X XXXXX X XXX XXXXX X XXX X X X X XXX XXXXX XXX X XXX X X XXXXXXX X XXXXXXXXXXX XXX X X XXX XXX XXXXX XXXXX X X XXX X X X X XXX X XXX X XXXXXXXXX X XXX X X XXX X
X   X     X X     X X     X         X   X   X   X     X   X   X   X X X X     X       X X     X X X X   X X X   X     X   X X X   X   X X   X   X   X X X   X X X X X   X X   X             X   X X     X
X XXXXXXX X X XXX X XXXXXXX XXXXXXX XXXXXXX X XXXXXXXXX X XXXXX XXX X XXXXX XXXXXXXXXXX XXXXXXX X X X X X X XXX X XXX XXX X X XXX XXX X X X XXX X XXX X X XXX X XXX X X X XXX XXXXXXXXXXXXXXX X XXXXX XXX
X X       X X X X X   X   X X     X X   X   X X   X   X X   X       X     X   X       X X   X     X X X   X     X   X     X   X X   X X   X   X X X   X X   X X       X X   X X     X   X     X X   X X X
X X X XXX X X X X X XXX X X X XXX X X XXX XXX X X X X X X XXX XXXXXXXXXXX XXX X XXXXX X XXX X XXXXX X XXXXXXXXXXXXX XXXXXXXXXXX XXX X XXXXXXXXX X XXXXX XXX X XXXXXXXXXXXXX XXX XXX X X X XXXXXXX X X X X
X X X X X X     X   X   X X X X   X X     X   X X X X   X     X       X   X     X   X X   X X X   X X             X X             X   X         X       X   X     X     X   X   X X   X   X     X X X   X
X XXX X X XXXXXXXXXXX XXX XXX X XXX X XXXXXXX X X X XXXXXXXXXXX X XXX X X XXXXXXX X X XXX X X X X X XXXXXXXXXXXXX X X XXXXXXXXXXX XXXXX XXXXXXX XXXXXXXXX XXXXXXX X XXX X XXX XXX XXXXXXX X XXX X X XXXXX
X   X X X     X     X   X     X X   X     X   X X   X X       X X X   X X X   X   X X X   X X   X X     X       X X             X     X X     X     X     X   X   X   X   X   X X   X     X X X   X X   X
XXX X X XXXXX X XXX XXX XXXXXXX X XXXXXXX X XXX XXXXX X X XXXXX X X XXX XXX X XXX X X X XXX XXXXX XXX X X XXXXXXX XXXXXXXXXXX XXX XXX X X XXXXXXXXX X XXX X X XXX XXX XXX X XXX X X X XXXXX X XXXXX X X X
X   X X X     X X X     X     X X X     X X   X   X   X X     X X X   X   X X X   X X X X       X     X X       X X   X     X X   X X   X         X X   X   X   X     X X X X     X       X X     X   X X
X XXX X X XXXXX X XXXXXXX X XXX X XXX XXX XXX XXX XXX X XXXXX X X XXXXXXX X X X XXXXX X X XXXXX XXXXXXX XXXXX X X X X X XXX X X XXX XXXXX XXX XXXXX XXXXXXXXXXX XXXXXXX X X X XXXXXXXXXXXXX X X XXXXXXX X
X     X X   X   X         X     X   X   X       X   X       X   X X     X   X X X   X X X   X X       X     X X X   X   X   X X X   X     X X X     X         X X       X X X         X     X X X   X   X
XXXXXXX XXX X XXXXX XXXXXXXXXXXXXXX X X XXXXX XXXXX XXXXXXX XXXXX X XXX X XXX X X X X X XXX X XXX XXX XXXXX X X XXXXXXXXX XXXXX X XXX XXXXX X X XXXXX XXXXXXX X XXXXXXX X X XXXXXXXXX X XXXXX X X X X XXX
X     X     X X   X       X       X X X     X X     X   X     X   X X X X X   X   X     X X   X   X   X     X X         X   X   X X   X X   X   X       X       X     X X X X     X   X X     X X X   X X
X XXX X XXXXX X X XXXXXXX X XXXXX X X XXX XXX X XXXXX X XXXXXXX XXX X X XXX XXX XXXXXXXXX XXX X XXX XXX XXXXXXXXX XXXXXXXXX X XXX X XXX X X XXXXX XXXXX XXXXXXXXX XXX X X X XXXXX X XXX XXX XXX X XXXXX X
X   X X X   X X X X       X X   X   X   X     X   X   X         X   X   X   X   X   X         X X   X   X     X   X       X   X   X   X   X     X   X X       X     X X   X     X     X   X   X X       X
X X XXX XXX X X X XXXXXXX X X X XXXXXXX XXXXXXXXX X XXXXXXXXXXX X XXX XXX XXXXXXX X XXXXXXXXXXX XXXXX XXXXX X X X X XXX XXXXXXX X XXX X XXXXX XXXXX X XXXXXXX X XXXXX X XXXXXXX XXXXX XXX X X X XXXXXXXXX
X X     X   X X X X     X   X X     X   X X     X X X         X X X X   X     X   X X         X X   X     X X X X X X X X     X X     X X   X           X   X X   X   X X     X     X X   X X X X       X
X XXXXXXX XXX X X X XXX XXXXX XXXXX X XXX X XXX X X XXXXX X XXX X X XXX XXX X X XXX X XXXXXXX X X X XXXXX X X X X X X X X XXX X XXXXXXX X XXXXXXXXXXXXXXX X X XXX X XXX X XXX XXXXX XXX XXXXX XXX XXX X X
X X   X     X   X X X   X   X     X   X   X X X X X     X X     X X   X   X X X   X X X   X   X   X     X   X   X X   X     X X X   X   X         X       X X X   X X   X X   X   X   X     X     X   X X
X X X X XXX XXXXX X X XXX XXXXXXX XXXXX X X X X X X XXX XXX XXXXX X XXXXX XXX XXX X X XXX X XXXXXXXXX XXX XXXXX XXXXX XXXXXXX X X XXX XXX XXX XXX X XXXXXXX X X XXX X XXX X XXX X XXX XXXXX XXXXXXX XXX X
X X X X   X     X   X X   X     X X     X X   X   X   X   X X   X X X   X   X     X X     X         X     X   X X   X X X   X X X       X X   X X X X       X X   X X   X X     X   X     X X       X   X
X XXX XXX XXXXX XXXXX X XXX X X X XXXXX X XXX XXXXXXX XXX X X X X X X X XXX XXXXXXX XXXXX XXXXXXXXX X XXXXX X XXX X X X X X X X XXXXXXX XXX XXX X X X XXXXXXX X XXX XXX XXXXX XXX X X XXXXX X XXXXXXXXXXX
X   X       X       X X     X X X       X   X X       X X X X X X X X X   X             X X   X   X X   X   X     X     X X   X       X     X     X X       X   X   X X     X X   X X       X   X       X
XXX XXXXXXXXX X XXXXX X XXXXX XXXXXXXXXXXXX X X XXXXXXX X X X X X X X XXX XXXXXXXXXXXXX X X X X X X XXXXX XXXXXXXXXXXXXXX XXXXXXXXXXX XXXXXXX XXXXX XXXXXXX XXX X XXX XXXXX XXX XXXXXXXXXXXXX X X XXXXX X
X X X         X X     X   X   X     X   X   X X       X X X X X   X X X X         X   X X   X X X X   X   X           X   X       X X     X     X X     X X   X X   X     X   X X           X X   X   X X
X X X XXXXXXXXX X XXXXXXXXX XXX X XXX X X XXX XXXXXXX X X X X XXXXX X X XXXXX XXXXX X X XXXXX XXX XXX X XXX XXXXXXXXX X XXX XXX X X XXXXX XXXXX X XXXXX X XXX X XXX X X XXXXX X X XXXXXXX X XXXXXXX X X X
X X X X     X   X     X   X     X   X X X   X X     X   X X X   X   X   X   X       X X X   X   X X   X X X X   X     X     X X X X     X   X     X     X     X X   X X       X   X     X X     X   X X X
X X X XXXXX X XXXXXXX X X XXXXXXXXX X X XXX X X X XXXXX X X XXX X XXX XXX X X XXXXXXX X X X XXX X X XXX X X XXX X XXX XXXXXXX X X X XXX XXX XXXXXXX XXXXXXXXX XXX XXX XXXXXXXXXXXXX XXX X XXXXX X XXX X X
X X X     X X       X X X         X X X X   X X X       X X X   X X   X   X X X     X   X X     X X     X     X X X           X X X X   X   X     X         X X   X X X     X       X X X X   X   X X   X
X X XXX X X XXXXXXX X X XXXXXXXXX X X X X XXX X XXXXXXXXX XXX XXX X XXX XXX XXX XXX X XXX XXXXXXX XXXXXXXXXXX X X XXXXXXXXXXXXX X XXX X X XXX XXX XXX XXXXX X X XXX X X XXX X XXXXXXX X X X X XXXXX XXX X
X X   X X X         X X   X     X X   X     X X X       X   X   X   X X X X     X   X   X X   X           X X   X     X         X     X X X     X   X   X X X X X   X   X X X   X   X   X X X   X       X
X XXX X X X XXXXXXXXX XXX X XXX X XXXXXXXXX X X X XXXXX XXX XXX XXX X X X XXXXXXX X XXXXX X XXX X XXXXXXX X X XXXXXXX X XXXXXXXXXXXXXXX X XXXXX XXX XXX X X X X X X XXXXX X X X XXX X XXX X X XXX XXXXXXX
X   X X X X   X X   X X   X   X X       X   X X X X     X     X   X X X   X X   X X X     X     X X     X X X X   X   X   X     X       X       X   X     X X   X X       X X X   X X   X X X X   X     X
X X X XXX XXX X X X X X XXXXX X XXXXXXX XXXXX X X XXX XXX XXX XXX X X XXX X X X X X X XXXXXXXXX X X XXXXX X X X X X X XXX X X XXX XXXXXXXXXXXXXXX XXXXXXXXX XXXXX XXXXXXX X XXXXX X XXX X X XXX XXX XXX X
X X X   X X   X   X X X X     X         X     X X   X X   X X X   X     X   X X   X X         X X X X     X X X X   X X   X X     X       X     X     X     X   X X     X X   X   X   X   X X   X     X X
X X XXX X X XXXXXXX X X X XXXXXXXXXXXXX X XXXXX XXX X X XXX X X XXX XXXXXXX X XXXXX XXXXXXXXX XXX X X XXXXX X X XXX XXX XXXXXXX XXXXX XXXXX X X XXXXX X XXXXX X X X X XXX XXX X XXXXX XXXXX X XXXXXXXXX X
X X   X   X         X   X X             X X   X X   X X X   X X   X X       X X       X   X   X   X   X       X X X X   X     X X     X     X X     X X X     X X X X X     X   X     X     X           X
X X XXXXXXXXXXXXXXX XXXXX XXXXXXXXXXXXXXX X X XXX XXX X X X X XXX X X XXXXXXX XXXXXXX X XXX XXX XXXXX XXXXXXXXX X X X XXX XXX X X XXXXX XXXXX XXXXXXX X X XXX X X XXX X XXXXXXXXX XXX X XXX XXXXXXXXXXX X
X X X           X   X   X     X     X   X   X     X X   X X X   X X X X   X X     X     X   X       X   X       X X X     X   X   X     X   X X     X   X X   X X     X     X   X   X   X         X   X X
X X X XXXXXXX XXX XXX X XXXXX X XXX X X XXXXXXXXXXX XXXXX X XXX X XXX X X X XXXXX XXXXXXX XXXXXXXXX XXX X XXXXXXX X XXXXXXX XXXXXXX XXXXXXX X X XXX XXXXX X XXXXXXXXX XXXXX X X X X XXXXXXXXXXXXXXX X X X
X X         X         X     X     X   X                   X     X       X       X                   X     X               X                 X     X       X               X   X   X                 X   K
XXXXXXXXXXXXXXXXXXXXXXXXXXXXXXXXXXXXXXXXXXXXXXXXXXXXXXXXXXXXXXXXXXXXXXXXXXXXXXXXXXXXXXXXXXXXXXXXXXXXXXXXXXXXXXXXXXXXXXXXXXXXXXXXXXXXXXXXXXXXXXXXXXXXXXXXXXXXXXXXXXXXXXXXXXXXXXXXXXXXXXXXXXXXXXXXXXXXXXXXX
